10 10
8 8
AAAAAAAAAA
A A A   EA
A A A AAAA
A A A AA A
A AAA AA A
A A    A A
A A AA A A
A A AA A A
A   AA   A
AAAAAAAAAA